┌─────────────┐┌──────────┐┌──────────┐┌───────┐┌──────────┐
└───────────┐ ││ ┌──────┐ │└─────┐ ┌┐ │└──┐ ┌┐ ││ ┌──────┐ │
┌───────┐┌──┘ ││ │┌────┐│ └──┐┌──┘ ││ └──┐│ ││ ││ └─────┐│ │
│ ┌───┐ ││ ┌──┘│ ││ ┌──┘└──┐ ││ ┌──┘└──┐ ││ │└─┘└──┐ ┌──┘│ │
│ └──┐│ ││ │┌──┘ ││ └─────┐│ ││ │┌────┐│ ││ └──┐┌──┘ │┌──┘ │
└──┐ ││ ││ │└──┐ ││ ┌───┐ ││ ││ │└──┐ ││ │└──┐ ││ ┌──┘│ ┌┐ │
┌──┘ ││ ││ │┌──┘ ││ │┌─┐│ ││ └┘ │┌──┘ ││ └──┐│ └┘ │┌─┐│ ││ │
│ ┌──┘│ ││ ││ ┌──┘│ ││ ││ │└────┘│ ┌┐ │└──┐ ││ ┌──┘│ ││ ││ │
│ │┌──┘ ││ └┘ │┌──┘ ││ ││ └──────┘ ││ │┌──┘ ││ │┌──┘ ││ ││ │
│ │└────┘└────┘│ ┌──┘│ │└──┐ ┌─────┘│ ││ ┌──┘│ ││ ┌──┘│ ││ │
│ └───────────┐│ │┌──┘ └──┐│ └──┐┌──┘ ││ │┌──┘ └┘ │┌──┘ ││ │
└─────┐ ┌───┐ ││ │└─────┐ │└──┐ │└──┐ ││ │└─────┐ ││ ┌──┘│ │
┌─────┘ │┌─┐│ ││ └──┐┌──┘ └──┐│ └──┐│ ││ └──┐┌──┘ ││ │┌──┘ │
│ ┌─────┘│ ││ │└──┐ ││ ┌───┐ │└──┐ │└─┘└──┐ ││ ┌──┘│ ││ ┌──┘
│ │┌─────┘ ││ └──┐│ ││ │┌─┐│ │┌─┐│ └──┐┌──┘ ││ │┌──┘ ││ └──┐
│ │└─────┐ │└──┐ ││ ││ ││ ││ ││ │└──┐ ││ ┌──┘└─┘│ ┌──┘└──┐ │
│ │┌────┐│ └───┘ ││ ││ ││ ││ └┘ └──┐│ └┘ │┌─────┘ │┌────┐│ │
│ ││ ┌┐ │└───────┘│ ││ ││ │└─────┐ │└────┘│ ┌─────┘│ ┌┐ ││ │
│ └┘ ││ └─────────┘ └┘ ││ └──────┘ └──────┘ │┌─────┘ ││ └┘ │
└────┘└────────────────┘└───────────────────┘└───────┘└────┘