┌───────┐┌────┐┌────┐┌──────────┐┌─────────────────────────┐
└─────┐ ││ ┌┐ ││ ┌┐ ││ ┌────────┘│ ┌──────┐ ┌────────────┐ │
┌────┐│ └┘ ││ └┘ ││ ││ └────────┐│ └─────┐│ └──┐┌───────┐│ │
└──┐ │└────┘└────┘│ │└──┐ ┌───┐ │└─────┐ │└──┐ │└─────┐ ││ │
┌──┘ │┌──────────┐│ └──┐│ └──┐│ └─────┐│ └──┐│ └─────┐│ └┘ │
│ ┌┐ ││ ┌┐ ┌───┐ │└──┐ │└────┘│ ┌┐ ┌──┘└──┐ │└─────┐ ││ ┌──┘
│ ││ ││ ││ └──┐│ └──┐│ └─────┐│ ││ └──────┘ │┌─────┘ ││ │┌─┐
│ │└─┘│ │└──┐ │└──┐ │└─────┐ │└─┘│ ┌────────┘│ ┌─────┘│ ││ │
│ └──┐│ │┌─┐│ └──┐│ └──┐┌─┐│ └──┐│ └────────┐│ │┌─────┘ └┘ │
└──┐ ││ ││ │└──┐ │└──┐ ││ │└──┐ │└────────┐ ││ │└────────┐ │
┌──┘ ││ └┘ └──┐│ │┌──┘ └┘ └──┐│ └──┐┌────┐│ ││ └────────┐│ │
│ ┌──┘└─────┐ ││ ││ ┌──────┐ │└──┐ ││ ┌┐ ││ │└────────┐ │└─┘
│ │┌────────┘ ││ ││ │┌────┐│ │┌──┘ ││ ││ ││ └────────┐│ └──┐
│ ││ ┌────────┘│ │└─┘│ ┌┐ │└─┘│ ┌──┘│ │└─┘└──┐ ┌─────┘│ ┌┐ │
│ ││ └──┐┌────┐│ └──┐│ ││ └──┐│ └──┐│ └──────┘ │┌────┐│ ││ │
│ │└──┐ │└──┐ │└──┐ ││ │└──┐ │└──┐ │└──────────┘│ ┌┐ ││ ││ │
│ └──┐│ └──┐│ └──┐│ ││ └──┐│ │┌──┘ │┌────┐┌─────┘ ││ ││ ││ │
│ ┌──┘└──┐ │└──┐ ││ │└──┐ ││ ││ ┌──┘│ ┌┐ ││ ┌─────┘│ │└─┘│ │
│ └──────┘ └───┘ ││ └───┘ ││ └┘ └───┘ ││ └┘ │┌─────┘ └───┘ │
└────────────────┘└───────┘└──────────┘└────┘└─────────────┘