┌─┐┌───────┐┌────────────────┐┌──────────┐┌─────────────┐┌─┐
│ │└──┐ ┌──┘│ ┌──────┐ ┌─────┘│ ┌──────┐ ││ ┌───┐ ┌───┐ ││ │
│ └──┐│ └───┘ │┌────┐│ └──────┘ └─────┐│ ││ └──┐│ │┌─┐│ └┘ │
└──┐ ││ ┌─────┘│ ┌┐ │└────────────────┘│ │└──┐ ││ ││ │└──┐ │
┌──┘ ││ └──────┘ ││ └──┐┌────┐┌────────┘ └──┐│ ││ ││ │┌──┘ │
│ ┌──┘└──────────┘└──┐ │└──┐ ││ ┌───────────┘│ ││ ││ ││ ┌──┘
│ │┌────┐┌──────────┐│ └───┘ ││ └──┐┌────┐┌──┘ ││ ││ ││ │┌─┐
│ ││ ┌┐ ││ ┌──────┐ │└─────┐ │└──┐ ││ ┌┐ ││ ┌──┘│ ││ ││ ││ │
│ └┘ ││ ││ │┌────┐│ │┌────┐│ └──┐│ └┘ ││ └┘ │┌──┘ ││ ││ └┘ │
└────┘│ ││ ││ ┌──┘│ ││ ┌──┘└──┐ │└────┘│ ┌──┘│ ┌──┘│ │└──┐ │
┌─┐┌──┘ ││ ││ │┌──┘ ││ └──────┘ │┌────┐│ │┌──┘ │┌──┘ │┌──┘ │
│ ││ ┌──┘│ ││ ││ ┌──┘│ ┌────────┘│ ┌┐ ││ ││ ┌──┘│ ┌┐ ││ ┌──┘
│ └┘ │┌──┘ ││ ││ │┌──┘ │┌────────┘ ││ ││ ││ └──┐│ ││ ││ └──┐
│ ┌──┘└──┐ ││ ││ │└────┘│ ┌────────┘│ │└─┘└──┐ ││ │└─┘└──┐ │
│ │┌─────┘ ││ ││ └──┐┌──┘ │┌─┐┌─────┘ │┌────┐│ ││ │┌────┐│ │
│ ││ ┌─────┘│ │└──┐ ││ ┌──┘│ ││ ┌─────┘│ ┌┐ ││ ││ ││ ┌┐ ││ │
│ ││ └─────┐│ └───┘ ││ └──┐│ ││ └─────┐│ ││ ││ ││ └┘ ││ └┘ │
│ │└──┐ ┌┐ │└─────┐ ││ ┌┐ ││ │└─────┐ ││ ││ ││ ││ ┌──┘└────┘
│ └──┐│ ││ └─────┐│ ││ ││ ││ └──┐┌──┘ ││ ││ └┘ ││ │┌───────┐
└──┐ ││ │└─────┐ ││ │└─┘│ ││ ┌──┘│ ┌──┘│ │└────┘│ ││ ┌┐ ┌┐ │
┌─┐│ ││ │┌─┐┌──┘ ││ └──┐│ ││ │┌──┘ │┌──┘ └─────┐│ ││ ││ ││ │
│ ││ ││ ││ ││ ┌──┘└──┐ ││ ││ ││ ┌──┘│ ┌──────┐ ││ │└─┘│ ││ │
│ └┘ ││ └┘ ││ └──┐┌──┘ └┘ ││ ││ │┌─┐│ └──┐┌──┘ ││ └───┘ ││ │
│ ┌──┘└──┐ │└──┐ │└───────┘│ ││ ││ │└──┐ ││ ┌──┘└───────┘│ │
│ └─────┐│ │┌─┐│ └─────┐┌──┘ └┘ ││ └───┘ ││ └────────┐┌─┐│ │
└─────┐ ││ ││ │└─────┐ ││ ┌─────┘│ ┌─────┘└────────┐ ││ ││ │
┌─┐┌──┘ ││ └┘ │┌─────┘ ││ │┌────┐│ └──┐┌────┐┌─────┘ ││ └┘ │
│ ││ ┌──┘│ ┌──┘│ ┌─────┘│ ││ ┌┐ │└──┐ ││ ┌┐ ││ ┌─────┘│ ┌──┘
│ └┘ │┌──┘ │┌──┘ │┌────┐│ ││ ││ │┌──┘ ││ ││ ││ └──┐┌──┘ │┌─┐
│ ┌──┘└────┘│ ┌──┘│ ┌┐ ││ ││ ││ ││ ┌──┘│ ││ │└──┐ ││ ┌──┘│ │
│ └──┐┌─────┘ │┌─┐│ ││ ││ ││ ││ └┘ │┌──┘ ││ │┌──┘ ││ │┌──┘ │
└──┐ ││ ┌─────┘│ ││ ││ ││ │└─┘└────┘│ ┌──┘│ ││ ┌──┘│ ││ ┌──┘
┌──┘ ││ └──┐┌─┐│ └┘ ││ ││ │┌───────┐│ └──┐│ ││ │┌──┘ ││ └──┐
│ ┌──┘└──┐ ││ ││ ┌──┘│ ││ ││ ┌───┐ │└──┐ ││ ││ ││ ┌──┘└──┐ │
│ │┌─────┘ ││ ││ └──┐│ ││ ││ │┌─┐│ └───┘ ││ └┘ ││ └──────┘ │
│ ││ ┌─────┘│ │└──┐ ││ ││ ││ ││ │└───────┘└────┘└────────┐ │
│ ││ │┌─────┘ └──┐│ ││ ││ └┘ ││ └──────────────┐┌───────┐│ │
│ ││ ││ ┌────────┘│ ││ │└────┘│ ┌┐ ┌───────────┘│ ┌───┐ ││ │
│ └┘ ││ └─────────┘ ││ └──────┘ ││ └────────────┘ └──┐│ └┘ │
└────┘└─────────────┘└──────────┘└───────────────────┘└────┘