┌─┐┌──────────────────────────────────┐┌──────────┐┌───────┐
│ │└─────┐ ┌─────────┐ ┌─────────┐ ┌──┘│ ┌┐ ┌┐ ┌──┘│ ┌┐ ┌┐ │
│ └─────┐│ └──┐┌────┐│ └──┐┌─────┘ │┌──┘ ││ ││ │┌──┘ ││ ││ │
└─────┐ │└──┐ ││ ┌┐ │└──┐ │└───────┘│ ┌──┘│ ││ ││ ┌──┘│ │└─┘
┌─┐┌──┘ │┌──┘ └┘ ││ └──┐│ └────────┐│ └──┐│ ││ ││ │┌─┐│ └──┐
│ ││ ┌──┘│ ┌─────┘└────┘└──┐ ┌───┐ │└──┐ ││ ││ ││ ││ │└──┐ │
│ └┘ │┌──┘ │┌─────────────┐│ └──┐│ └───┘ ││ ││ ││ └┘ └──┐│ │
│ ┌──┘│ ┌──┘│ ┌─────────┐ │└──┐ │└───────┘│ │└─┘└─────┐ ││ │
│ │┌──┘ │┌─┐│ └──┐┌────┐│ │┌─┐│ │┌────┐┌──┘ │┌────┐┌──┘ ││ │
│ ││ ┌──┘│ │└──┐ │└──┐ ││ ││ ││ ││ ┌┐ ││ ┌──┘│ ┌┐ ││ ┌──┘│ │
│ ││ └───┘ └──┐│ └──┐│ └┘ ││ └┘ ││ ││ ││ └───┘ ││ ││ │┌──┘ │
│ │└──────────┘│ ┌┐ │└──┐ ││ ┌──┘│ ││ ││ ┌─────┘│ ││ ││ ┌┐ │
│ └───────────┐│ ││ └──┐│ ││ │┌──┘ ││ ││ │┌────┐│ └┘ ││ ││ │
└───────────┐ ││ │└──┐ ││ │└─┘│ ┌──┘│ │└─┘│ ┌┐ │└──┐ ││ │└─┘
┌───────┐┌──┘ ││ └──┐│ ││ └──┐│ └──┐│ └──┐│ ││ └──┐│ ││ └──┐
│ ┌┐ ┌──┘│ ┌──┘└──┐ ││ │└──┐ │└──┐ │└──┐ ││ │└──┐ │└─┘└──┐ │
│ ││ └──┐│ │┌─────┘ ││ │┌─┐│ └───┘ │┌──┘ ││ │┌──┘ │┌────┐│ │
│ │└──┐ ││ │└─────┐ ││ ││ │└───────┘│ ┌──┘│ ││ ┌──┘│ ┌┐ ││ │
│ │┌──┘ ││ │┌────┐│ ││ ││ └─────┐┌──┘ │┌──┘ ││ │┌──┘ ││ └┘ │
└─┘│ ┌──┘│ ││ ┌┐ │└─┘│ ││ ┌─────┘│ ┌──┘│ ┌┐ ││ ││ ┌┐ │└──┐ │
┌──┘ │┌──┘ ││ ││ │┌──┘ ││ └─────┐│ │┌──┘ ││ ││ ││ ││ └──┐│ │
│ ┌┐ ││ ┌──┘│ ││ ││ ┌──┘│ ┌───┐ ││ │└────┘│ ││ │└─┘└──┐ ││ │
│ ││ ││ │┌──┘ ││ ││ │┌─┐│ │┌─┐│ └┘ │┌─────┘ ││ └─────┐│ ││ │
│ │└─┘│ ││ ┌──┘│ ││ ││ ││ ││ │└────┘│ ┌─────┘└─────┐ ││ ││ │
│ │┌──┘ ││ └──┐│ └┘ ││ └┘ └┘ └──┐┌──┘ │┌───────┐┌──┘ ││ ││ │
│ ││ ┌──┘│ ┌┐ │└────┘└────────┐ ││ ┌──┘│ ┌┐ ┌──┘│ ┌──┘│ ││ │
│ ││ └──┐│ ││ └───────────┐┌──┘ └┘ │┌──┘ ││ │┌──┘ │┌──┘ ││ │
│ │└──┐ │└─┘│ ┌─────────┐ │└───────┘│ ┌┐ │└─┘│ ┌──┘│ ┌┐ │└─┘
│ └──┐│ └──┐│ └─────┐┌─┐│ └────────┐│ ││ └───┘ │┌──┘ ││ └──┐
│ ┌┐ │└──┐ │└─────┐ ││ │└────────┐ ││ │└───────┘└────┘└──┐ │
│ ││ └──┐│ │┌─┐┌──┘ ││ └──┐┌─┐┌──┘ ││ └──┐┌───────┐┌─────┘ │
│ │└──┐ ││ ││ ││ ┌──┘│ ┌┐ ││ ││ ┌──┘└──┐ ││ ┌┐ ┌┐ ││ ┌───┐ │
│ └──┐│ └┘ ││ ││ └───┘ ││ └┘ ││ │┌────┐│ ││ ││ ││ ││ │┌──┘ │
└──┐ │└────┘│ │└───────┘│ ┌──┘│ ││ ┌┐ ││ │└─┘│ ││ ││ │└──┐ │
┌─┐│ │┌────┐│ └─────────┘ │┌──┘ ││ ││ ││ └───┘ ││ ││ └──┐│ │
│ ││ ││ ┌┐ │└─────────────┘│ ┌──┘│ ││ │└───────┘│ ││ ┌┐ ││ │
│ └┘ ││ ││ └──┐┌───────┐┌──┘ │┌──┘ ││ └──┐┌─────┘ ││ ││ ││ │
│ ┌──┘│ │└──┐ ││ ┌───┐ ││ ┌──┘│ ┌──┘└──┐ ││ ┌─────┘└─┘│ ││ │
│ └───┘ │┌──┘ └┘ │┌──┘ └┘ │┌──┘ └─────┐│ └┘ └─────────┘ ││ │
└───────┘└───────┘└───────┘└──────────┘└────────────────┘└─┘