┌──────────┐┌───────┐
└────────┐ │└─────┐ │
┌────┐┌──┘ │┌─────┘ │
│ ┌┐ ││ ┌──┘│ ┌───┐ │
│ ││ ││ │┌──┘ │┌──┘ │
│ ││ ││ ││ ┌┐ │└────┘
│ ││ └┘ ││ ││ └─────┐
│ │└────┘│ │└─────┐ │
│ │┌─┐┌──┘ └─────┐│ │
│ ││ ││ ┌────────┘│ │
│ ││ └┘ └──┐┌─────┘ │
│ │└───────┘│ ┌───┐ │
│ └─────────┘ │┌──┘ │
└─────────────┘└────┘