┌───────┐┌──────────┐┌─┐
└─────┐ │└──┐ ┌───┐ ││ │
┌────┐│ └──┐│ └──┐│ └┘ │
│ ┌┐ │└──┐ │└──┐ │└────┘
│ ││ └──┐│ └──┐│ │┌────┐
│ │└────┘└──┐ ││ ││ ┌┐ │
│ └──┐┌────┐│ ││ └┘ ││ │
│ ┌┐ ││ ┌┐ ││ │└────┘│ │
│ ││ └┘ ││ ││ └──────┘ │
│ │└────┘│ │└────────┐ │
│ │┌────┐│ │┌────┐┌──┘ │
│ ││ ┌┐ ││ ││ ┌┐ ││ ┌──┘
│ └┘ ││ ││ └┘ ││ └┘ └──┐
└────┘└─┘└────┘└───────┘